################################################################################
#..............................................................................#
#..............................................................................#
#..............................................................................#
#.........@....................................................................#
#..............................................................................#
#..............................................................................#
#..............................................................................#
#..............................................................................#
#..............................................................................#
#..............................................................................#
#..............................................................................#
#..............................................................................#
#................................................................@.............#
#..............................................................................#
#..............................................................................#
#..............................................................................#
#..............................................................................#
#..............................................................................#
#..............................................................................#
#..............................................................................#
#..................................................@...........................#
#..............................................................................#
#..............................................................................#
################################################################################